отец - father
мать - mother
папа - dad
мама - mom
брат - brother
сестра - sister
сын - son
дочь - daughter
жена - wife
муж - husband
родители - parents
дети - children
ребенок - child
бабушка - grandmother
дедушка - grandfather
внучка - granddaughter
внук - grandson
дядя - uncle
тётя - auntie
племянник - nephew
племянница - niece
двоюродный брат - cousin (male)
двоюродная сестра - cousin (female)
семья - family
родственники - relatives
близнецы - twins
детство - childhood
малыш, грудной ребенок - baby
мальчик - young boy
девочка - young girl
девушка - young woman
молодой человек - young man
мужчина - man
женщина - woman
человек - person
взрослый - adult
невеста - bride
жених - groom
медовый месяц - honey moon
брак - marriage
замужем, женатый - married
жениться, выходить замуж - marry
холостой - single
вдова - widow
вдовец - widower
