#==============================================================================
@name 1.a Понимание
#==============================================================================

@type adverb
равноце'нно - equivilant to
поми'мо - besides, beside, aside from
наско'лько - by how much, as far as
едва' - barely
ли'чно - personally, in person
мра'чно - gloomy

@type adjective
недово'льный - dissatisfied, unhappy
входя'щый - incoming, entering
междунаро'дный - international, between nations
полуоткры'тый -- half-open
сло'женный - folded
покрыва'ющий - covering
приглушённый - muted
и'стинный - true, genuine

@type noun
эпитет - term, epithet, adjective
пове'рхность - surface
па'пка - folder
сто'пка - stack, shot glass
темнота', тьма' - darkness, gloom, obscurity
обяза'нность - duty, responsibility
совпаде'ние - coincidence
подборо'док - chin
та'ктика - tactic, tactics
тишина' - quietness
сто'н - groan
пищевика' - food
подземе'лье - dungeon
изме'на - treason
отправле'ние - departure
ме'лочь - trifle, little thing
чула'н - closet, room under staircase

@type verb
домини'ровать - to dominate
награжда'ть - to reward, award
описа'ть - to describe
враща'ться - to rotate
поглоща'ть - to absorb, swallow, consume
поглати'ть - to absorb, swallow, consume
наклони'ться - to bend over
выгля'дывать - to look out, peek out
подсчита'ть - to tally up, count
чини'ть - to inflict, commit
учиня'ть - to inflict, commit
осознава'ть - to be aware, recognize
подозрева'ть - to suspect, surmise
зароди'ть - to excite, to raise thought, idea, feeling
вы'разить - to express, voice
припля'сывать - to dance, move legs
произнести' - to pronounce, get out
зада'ть - to charge, entrust someone to do something
руши'ться - to collapse
разда'ться - to be heard
подсо'вывать - to slip, put under
пихну'ть - to shove
пови'снуть - to hang
достуча'ться - to reach out
дозволи'ть - to allow
просу'нуть - to push through
утеша'ться - to take confort, be consoled
существова'ть - to exist
кину'ть - to throw, cast
##duplicate## укра'сть - to steal
обьявля'ть - to declare, announce
марширова'ть - to march
запи'хивать - to stuff in, box up

@type phrase
я ду'мая, я влу'блена -- I think I'm in love

@type other

@type particle

@type conjunction
ка'бы - if only (если бы)

@type interjection

@type preposition
