#==============================================================================
@name 3.a Дискуссия
#==============================================================================

@type adverb
два'жды - twice
мно'жество - many, very large quantity of

@type adjective
долгосро'чный -- long-term
неизмери'мый - immeasurable
удовлетворённый - satisfied
унизи'тельный - humiliating
обма'нутый - cheated, deceived
теку'щий - current
заде'тый - hurt, affected
незри'мый - imperceptable, invisible
изя'щный - graceful
разделённый - divided
неразделённый - undivided
сму'тный - vague, unclear

@type noun
разгро'м - ruin, devestation
разруше'ние - destruction
вы'печка - bakery products
кро'шка - crumb
глазу'рь - frosting, glaze
жере'бчик -- colt (baby horse)
жеребёнок, жеребя'та -- foal, filly
ме'ра - measure
скло'нность - constant attraction to smth
кра'йность - the extreme
гру'з - cargo, goods
любопы'тство - curoisity
де'йствие - an action
пра'х, пы'ль - dust, ash
кли'н - wedge
черёд - turn, time

@type verb
удовлетвори'ть - to satisfy @pf
удовлетворя'ть - to satisfy @impf
откуси'ть - to take a bite
прекраща'ть - to cease, discontinue, stop
восхища'ться - to admire @impf
восхити'ться - to admire @pf
причини'ть - to produce, cause smth
втащи'ть - to drag in
мурлы'кать - to purr
уда'рить - to bump, hit
унизи'ть - to humiliate
###duplicate###вы'кинуть - to throw out
уви'ливать - to wriggle out
свали'ть - to knock down; go away, emigrate
хму'риться - to frown
предприня'ть - to undertake, start to do smth
грузи'ть - to ship, load
расстро'ить - to upset, break the order of smth
обрати'ться - to turn to the direction of smth
превзойти' - to surpass
обвиня'ть - to blame, accuse
указа'ть - to specify, indicate, point out
подогре'ть - to heat up a little
испепели'ть - to incinerate
вби'ть - to drive in, hammer
подтолкну'ть - to lightly push
пересека'ть - to cross, traverse
повреди'ть - to hurt, damage
предста'вить - to represent, present

@type phrase
в свою' о'чередь - in turn
и впря'мь - really, indeed

@type other

@type particle

@type conjunction

@type interjection

@type preposition


