#==============================================================================
@name 3.b Дискуссия
#==============================================================================

@type adverb
беспе'чно - carelessly

@type adjective
ло'вкий - agile, clever 
нело'вкий - akward, clumsy
беспреце'дентый - unprecedented
осо'бый - particular, special
трево'жный - anxious
ледя'ный - icy
патру'лный - patrol (adj.)
неуме'стный -  irrelevant
уме'стный - relevant
ослеплённый - blinded

@type noun
ло'вкость - agility, dexterity
нело'вкость - akwardness
упомина'ние - mention
сокры'тие - concealment
изги'б - bend, curve
###duplicate###бро'вь - eyebrow
звоно'к - metal bell, signal device
похожде'ние, приключе'ние - adventure
слу'х - hearing (the sense)
слу'хи - gossip 
освобожде'ние - liberation
гаре'м - harem
возраже'ние - objection
выраже'ние - expression (same as in English)
добавле'ние - addition, adding
ло'б - forehead
обстоя'тельство - circumstance
грёза - fantasy, dreamworld
исто'чник - source, spring, fount

@type verb
удивля'ть - to suprise @impf
удиви'ть - to suprise @pf
боготвори'ть - to worship
подда'ться - to succumb
###duplicate###вста'ть - to stand up
рассе'ять - to scatter, dispel, dissipate
по'ртить - to spoil
проника'ть - to infiltrate, penetrate
кашля'ть - to cough
кашля'нуть - to give a cough
изгна'ть - to drive out
вы'черкнуть - to cross out
рассчита'ть - to calculate
###duplicate###ло'пнуть - to burst
искорени'ть - to eradicate
воспринима'ть - to perceive
###duplicate###оста'ться - to stay
очарова'ть - to charm, enchant, fascinate @pf
очаро'вывать - to charm, enchant, fascinate @impf
претендова'ть - to claim, pretend
запреща'ть - to forbid
убра'ть - to remove, place somewhere
дели'ться - to share
дели'ть - to device, divvy
копи'ть - to save up, hoard
пробормата'ть - to mumble, say quickly/unclearly 
отправля'ться - to set off
уха'живать - to court, woo, look after
разнести' - to spread, carry to different places
возрази'ть - to object @pf

@type phrase

@type other

@type particle

@type conjunction

@type interjection

@type preposition


