#==============================================================================
@name New 13
#==============================================================================

@type adjective
свобо'дный - free, spare, vacant
по'лный - full, total, complete
прохла'дный - chill, cool
положи'тельный - positive
не'рвный - nervous
забо'тливый – careful, attentive
про'шлый - last, past, previous

@type adverb
пло'тно - tightly, thickly
све'рху - from above, on top of
вовсе' - at all (old style word)
по'лностью - fully, completely
сро'чно – urgent

@type noun
исправле'ние - correction
опа'сность - danger
полго'да -- half-year
полови'на - half
та'йна - secret
обеща'ние - promise
молча'ние - silence
зло'сть - anger
ше'рсть - wool, fur, coat
тротуа'р - sidewalk, pavement
кри'тика - criticism
наро'д - people, nation
буты'лка – bottle
зо'нт – umbrella
ава́рия – accident
рома́н – novel
табле́тка – tablet, pill
пу'нкт – point, item, article
прика́з – order, command
слу'х - hearing
мо'зг - brain
злоде'й - villian, fiend
пользова́тель – user
просту́да – cold (illness)
ра́зум – reason
сцена́рий – scenario, script
удово́льствие – satisfaction, pleasure
су'д – court, trial
велосипе'д - bicycle
рюкза'к - backpack
бага'ж - luggage
пюре' - mashed potatoes

@type verb
разбира'ться - to deal with
запуска'ть - to launch, run @impf
сдержа'ть - to hold back, restrain @pf
размышля'ть - to ponder, reflect, speculate
темне'ть - to darken
рехну'ться - to go crazy
пресле'довать - to chase, persue
разброса'ть - to scatter
исчеза'ть - to dissapear, vanish, pass away
пыта'ться - to try, attempt @impf
# Three words for : to try
# https://forum.wordreference.com/threads/%D0%BF%D1%80%D0%BE%D0%B1%D0%BE%D0%B2%D0%B0%D1%82%D1%8C-%D1%81%D1%82%D0%B0%D1%80%D0%B0%D1%82%D1%8C%D1%81%D1%8F-%D0%BF%D1%8B%D1%82%D0%B0%D1%82%D1%8C%D1%81%D1%8F.1058229/
вы'сказать - to express @pf
тошни'ть @acc - to cause nausia, to make sick @impf
лома'ть – to break @impf
слома'ть – to break @pf
запи́сываться – to enroll, register, sign up @impf
руга́ться – to swear, curse @impf
создава'ть - to create @impf
созда'ть - to create @pf
теря'ть – to lose (something) @impf
привлека́ть – to attract
выдава'ть – to give, distribute @impf
вы'дать – to give, distribute @pf
забо'титься @prep - to take care of, look after
управля'ть – to manage

@type phrase
я согла'сен - I agree
Я ничего раньше подобного не видела! - I have never seen anything like this before!
то' е'сть - that is, that is to say, i.e.
Не за что﻿ - It's my pleasure
до ско'рого - see you soon

@type preposition
вро'де @gen - like, such as
во'зле @gen - by, near

@type other

@type conjunction

@type interjection


