#==============================================================================
@name New 18
#==============================================================================

@type adjective
бездо'мный - homeless
досто'йный - worthy
засте'нчивый - shy
вслу'х - aloud
я'вный - obvious
токси'чный - toxic

@type adverb
здо'рово - very good, perfect
обра'тно - back, return, inverse, opposite

@type noun
прода'жа - sale (purchase)
приме'рочная - fitting room
ка'сса - register
ве'ер - fan (hand fan)
сда'ча - change (money)
нали'чные (ден'ьги) - cash
зна'ния - knowledge
образова'ние - education, formation
гла'сность - publicity
перестро'йка - reconstruction
во'р - theif
за'мка из песка' - sand castle
положе'ние - position, location, situation
влече'ние - attraction
вселе'нная - universe
ребя'та - guys, children
же'мчуг - pearl
ме'х - fur
пробужде'ние - awakening
бро'вь - eyebrow
ры'нок - market, mart
сце'на - scene
назначе'ние - purpose, assignment, function
противостоя'ние - standoff
беспоко'йство - anxiety, concern
сковорода' - frying pan
ки'сть - brush

@type verb
поме'рить - to measure
проста'ивать -  to stand idle
положи'ть - to put @pf
вложи'ть - to invest @pf
вы'ложить - to take something out and put it @pf
приложи'ть - to put and hold in place @pf
переложи'ть - to move something from one place to another @pf
стреми'ться - to aspire, aim, seek
предава'ть - to betray @impf
оби'деть - to offend @pf
обижать - to offend @impf
пережива'ть - to worry, relive
сомнева'ться - to doubt
прильну'ть - to snuggle, nestle
хихи'кать - to giggle @impf
хихи'кнуть - to giggle @pf
расслабля'ться - to relax, loosen up
сража'ться - to battle

@type phrase
у + gen. + получилось + verb -- to manage to do something
	@ex У меня получилось водить машину
ви'димо, ...; похо'же, ... -- it seems like ...
	@ex Видимо, я её обидел -- It seems like I offended her
	@ex Похоже, он не придёт -- It seems like he won't come
собира'ться + verb -- to get ready, to plan, to intend to do soemthing
почему ты мне раньше это не рассказывал? -- Why haven't you told me this before?
чево мы стоим -- what we're made of
вы'летело из головы' - flew out of my head, it was at the tip of my tongue
снима'ть ви'део - to shoot a video
ух ты! - wow, woah!
где бы ты не был - wherever you are

@type other

@type particle
ра'зве - really, (suprise, doubt, concern)
неуже'ли - really!, emotional (suprise, doubt, concern)

@type conjunction

@type interjection

@type preposition
насчёт - concerning, about

