#==============================================================================
@name New 07
#==============================================================================

@type adjective
подзе'мный – underground
подво'дный - underwater
ядови'тый – poisonous
непохо'жий - different
ую'тный - cozy
холосто'й - single, unmarried

@type adverb
наконе'ц-то – finally, at last
действи'тельно - actually, truely, really

@type noun
наре'чие - adverb
а'рмия – army
би'тва – battle
бо'чка – barrel
горизо'нт – horizon
ками'н – fireplace
дымохо'д – chimney
ку'кла – doll
лу'жа – puddle
о'чередь – queue
я'д – poison
янта'рь – amber
ширина' – width
ого'нь - fire
пожа'р - large fire, conflagration
ска'зка – fairy-tale
сти'х – verse, poetry
преде'л - limit
салфе'тка - napkin
боле'знь – illness, disease

@type verb
успоко'ить - to calm, soothe, reassure
проголода'ться - to get hungry @pf
аплоди'ровать – to applaud
перебива'ть – to interrupt
тра'тить – to spend @impf
шмыгну'ть - to dart, dash, scramble @pf
ката'ться - to roll, ride in a vehicle, ski, bicycle, snowboard @impf
доста'ть - to reach, fetch, obtain @pf
брони'ровать – to reserve, book, make a reservation

@type phrase
всё равно' – it’s all the same, who cares

@type preposition

@type other
кста'ти - by the way

@type conjunction

@type interjection
Уда́чи! – Good luck!