#==============================================================================
@name New 01
#==============================================================================

@type adjective
бога́тый - rich
вку́сный - tasty
невку́сный – not tasty
неприя́тный – not pleasant
неудо́бный – not comfortable
кури́ный – chicken (adj.)
сти́льный – stylish, trendy
изве'стный - famous
люби'мый - favorite
шти'ль - calm
харизмати'чный - charismatic
вся'кий - all sorts of
любо'й - any

@type adverb
конкре́тно – specifically
отли́чно – perfect, excellent
пра́вильно – correct
однозна'чно - definitely
лу'чше - better
ху'же - worse
ча'ще - more often
одина'ковый - same

@type noun
стиль – style
цена́ – price
война́ - war
зака́з – order
зву'к – sound
игра́ – game
интелле́кт – intelligence
ми'р – world
па́мять – memory
идио́т – idiot
курье́р – delivery person
озву'чка - voice acting
кома'нда - team (sport team)
приме'р - example
куми'р - idol
произноше'нии - pronounciation
трава' - grass
уче'бник - textbook
глаго'л - verb
кино' - theater, cinema
по'езд - train
движе'ние - motion, movement
охра'на - security
посла'ние - message

@type verb
забыва́ть – to forget
спо́рить – to argue
сто́ить – to cost
сни'ться - to dream (during sleep)
побежда'ть - to win
зна'чить - to mean, signify
учи'ться - to study at educational institution; to learn something by yourself
обуча'ть - to learn something by yourself systimatically
изуча'ть - to study something (with in depth approach)
обожа'ть - to adore @impf
уважа'ть - to respect
отбы'ть - to depart @pf
отбыва'ть - to depart @impf
шути'ть - to joke, kid @impf
назна'чить - to schedule @pf
извини'ться - to apologize @pf
прости'ть - to excuse, forgive @pf
испо'льзовать - to use @impf
предполага'ть - to assume, suppose, guess @impf
предположи'ть - to assume, suppose, guess @pf
предлага'ть - to offer, propose, suggest @impf
предложи'ть - to offer, propose, suggest @pf
###duplicate### ста'вить - to put, set
поднима'ться - to rise, get up @impf
подня'ться   - to rise, get up @pf
вдохновля'ть - to inspire @impf

@type other
возмо'жно - it is possible
невозмо'жно - it is impossible
замеча'тельно! - wonderful!
