#==============================================================================
@name New 02
#==============================================================================

@type adjective
родно'й - native
шика'рный - chic, posh, stylish @long
шика'рен - gorgeous @short
уда'чный - successful

@type adverb
вме'сте - together
вно'вь - again
наве'рное - probably
ненадо'лго - briefly, for a short time
осо'бенно - especially

@type noun
це'ль - goal, target
ко'нкурс - competition
отпу'ск - vacation
терпе'ние - patience
хозя'ин - master
торго'вец - merchant
корзи'на - basket
ма'рка - stamp
зада'ча - problem, task
красота' - beauty
карикату'ра - cartoon
любо'вь - love
ви'д - view, look
успе'х - success
сериа'л - TV series
се'рдце - heart
взгля'д - sight, view
при'зрак - ghost
го'сть - guest
жа'ль - pity
жара' – heat
побе'да – victory
пода'рок – gift
душа' - soul
дика'рка - savage (person)
слеза' - tear, teardrop
исполне'ние - performance
чесно'к - garlic
а'втор - author
чува'к - dude
мультфи'льм - animated film
пе'сня - song
шеде'вр - masterpiece

@type verb
##спа'ть - to sleep @impf
зака'зывать - to order @impf
зака'зать - to order @pf
пока'зывать - to show @impf
пока'зать - to show @pf
стара'ться - to try @impf
постара'ться - to try @pf
успе'ть - to have time @pf
стыди'ться - to be ashamed @impf
заду'мать - to conceive, plan @pf
отлича'ться - to differ @impf
жела'ть - to wish, desire @impf
скро'мничать - to be shy @impf
###пря'тать - to hide @impf
спря'тать - to hide @pf
напомина'ть - to remind @impf
почита'ть - to revere, honor
охраня'ть - to gaurd @impf
зако'нчить – to finish, be done with
плани'ровать – to plan
оста'вить - to leave (something)
моли'ться - to pray @impf
расти'ть - to raise
запла'кать - to begin to cry

@type phrase
ка'к же' э'то ___! - how ___ is that!

@type other
ла'дно - okay
коне'чно - of course
то'же (я то'же) - too, also (me too)
прости'те - sorry
вообще' то, ... - in general, ...

