@name Misc Food
@key food_misc

крупа - grain
овес - oatmeal
гречка - buckwheat
ячмень - barley
пшено - millet
рис - rice

мороженое - ice cream
сыр - cheese
яйцо - egg
масло - butter
картофель фри - french fries
жевательная резинка, жевачка - (chewing) gum
варенье - jam
пицца - pizza
конфета - candy
батончик - candy bar
сосиска - hotdog
томатный соус - ketchup
соус - sauce
колбаса - sausage
салат - salad
бутерброд - sandwich
суп - soup
сметана - sour cream
пища - meals
завтрак - breakfast
обед - lunch
ужин - dinner
полдник - supper
