#==============================================================================
@name New 19
#==============================================================================

@type adjective
неприли'чный - indecent
прили'чный - decent
изря'дный - fair, hefty, significant in quantity
престу'пный - criminal, felonious
живопи'сный - scenic, picturesque
беспла'тный -- free (without pay)

@type adverb
Вкра'тце, ... -- In short, ...

@type noun
призва'ние - calling, vocation
изумру'д - emerald
опеча'тка - typo
зарпла'та - salery
образе'ц - samplt
прива'л - a stop along the way 
распоряже'ние - disposition, order, command
барда'к - a complete mess
завоева'ние - conquest
награ'да - reward
уро'д - freak
деби'л - moron
схо'дка - gathering
маршру'т - route
пре'данность - devotion, dedication
америка'нский го'рки - roller coaster
ощуще'ние - feeling, sensation
нау'ка - science
ссы'лка - link, reference

@type verb
повы'сить - to increase, raise @pf
повыша'ть - to increase, raise @impf
выполня'ть - to accomplish, execute, perform @impf
выполни'ть - to accomplish, execute, perform @pf
любова'ться - to look at in pleasure 
пя'литься - to stare
наблюда'ть - to observe (empirically) 
вы'глядеть - to look (appearance)
###duplicate###ле'чь - to lie down
распакова'ть - to unpack
хорони'ть - to bury, tomb, lay to rest
слива'ться - to flow together, merge, fuse @impf
сли'ться - to flow together, merge, fuse @pf
защища'ть - to protect
суди'ть - to judge
пожа'ловать - to welcome
скуча'ть - to miss due to absance; to feel bored
шпио'нить - to spy
задрема'ть - to doze off
дра'лить -- to tear up (teardrops)
набра'ть - to dial
сомнева'ться - to doubt

@type phrase
никогда' ещё не' было ничего' и никого' подо'бного - there has never been anything or anyone like this
та'к нельзя' - you can't do it in this way
Что' ты хо'чешь, что'бы я сказа'л? -- What do you want me to say?
де'ньги не па'хнуть - money doesn't smell (the ends justify the means)
уда'рить в гря'зь лицо'м - to fall into the dirt face first
у чёрта на кули'чиках - hell knows where
утра' ве'чера мудрене'е - morning is wiser than the evening (lets sleep on it)
ни с ме'ста - Don't move!
я име'ю в виду', ... -- I mean, ...
как тебе' уго'дно - as you please

@type other

@type particle

@type conjunction

@type interjection

@type preposition

